AAN = "countries/Anarchy.txt"
ROE = "countries/Roman_Empire.txt"
MAU = "countries/Mauretania.txt"
LYC = "countries/Lycia.txt"
THR = "countries/Thracia.txt"
BOP = "countries/Bosporan_Kingdom.txt"
CAP = "countries/Cappadocian_Kingdom.txt"
PON = "countries/Pontus.txt"
JUD = "countries/Judea.txt"
XIN = "countries/Xin_Dynasty.txt"
ANN = "countries/Han_Dynasty.txt"
WPC = "countries/Western_Protectorate_of_China.txt"
CLC = "countries/Colchis.txt"
IBR = "countries/Iberia_Georgian.txt"
ARR = "countries/Greater_Armenia.txt"
SOP = "countries/Sophene.txt"
CCA = "countries/Caucasian_Albania.txt"
PTH = "countries/Parthian_Empire.txt"
XAI = "countries/Xiongnu.txt"
SAV = "countries/Satavahana_Dynasty.txt"
AYD = "countries/Ay_Dynasty.txt"
CER = "countries/Chera_Dynasty.txt"
ANU = "countries/Anuradhapura.txt"
SAT = "countries/Samatata.txt"
YAU = "countries/Yaudheya_Republic.txt"
CLO = "countries/Chola_Dynasty.txt"
PDA = "countries/Pandya_Dynasty.txt"
MTH = "countries/Mathura.txt"
MMD = "countries/Mahame_Dynasty.txt"
YUZ = "countries/Yuezhi.txt"
MTI = "countries/Mitra_Dynasty.txt"
IDS = "countries/Indo_Scythian.txt"
CTU = "countries/Chutu_Dynasty.txt"
NAB = "countries/Nabatea.txt"

MAH = "countries/Mahan_Confederacy.txt"
BYE = "countries/Byeonhan_Confederacy.txt"
JIN = "countries/Jinhan_Confederacy.txt"
EYE = "countries/Dongye.txt"
OKJ = "countries/Okjeo.txt"
GOR = "countries/Goguryeo.txt"
BAE = "countries/Baekje.txt"